00000000000000000000000000000000000010000000000000000111111111100000000000000000
00000000000000000000000000000000000040000000000000000100000000100000000000000000
00000000000000000000000000000000000010500000000000000101111110100000000000000000
00000000000000000000000000000000000010000000000000000101000010100000000000000000
00000000000000000000000000000000011111100000000000000101011410100000000000000000
00000000000000000000000000000000010000100000000000000101011110100000000000000000
00000000000000000000000000000000010305100000000000000101000000100000000000000000
00000000000000000000000000000000010000040000000000000101111111100000000000000000
00000000000000000000000000000000011111110000000000000005000000000000000000000000
00000000000000000000000000000000000010000000000000000000000000000000000000000000
00000000000000000000000000000000000010000000000000000000000000000000000000000000
00000000000000000000000000000000000010000000000000000000000000000000000000000000
00000000000000000000000000000000000010500000000000000000000000000000000000000000
00000000000000000000000000000000000040000000000000000000000000000000000000000000
00000000000000000000000000000000000010000000000000000000000000000000000000000000
