130511111111111111111000000000011111
160040000000000000000000404000000000
111111111111101111111000050000010006
111111111111101000001000404000010000
111111111111101060001600000006010060
111111111111101000601111111111110000
111000000000001000000000010000000000
111011111111111000000000010060000000
111000000000001006000000015000000000
111111111111101000600000040000000500
111000000000001000000600010061010101
111011111111111600000000010000101010
111514000000000000000000616060010101
