130511111111111111111000404000011111
160040000000000000000000050000000000
111111111111101111111600404000010006
111111111111101000601111111111110000
111000000000001000000000010000000000
111011111111111000000000010060000000
111000000000001006000000015000000000
111111111111101000600000040000000500
111500000000001000000600010061010101
111111111111111600000000010000101010
908740000000000000000000616060010101
