111111111111111111111111111111111111111111111111111111111111
102020202020202020211000000000000000000100000000000000000000
120202020202020202011000000000010000000000000000000100000001
100000000000000000000000000000010000000110000000000100000001
100000000000000000011000000000010000000110000000000000000001
100000000000000000011000000000010000000110000000000100000001
100022000001000000011000000000010000000110000000000100000001
100022000001000000011000000000010000000110000000000100000001
100000000001000000011000000000010000000110000000000100000001
100000000001000000011000000000010000000110000000000100000001
100000000001000000011000000000010000000110000000000100000001
100000000001000000011000000000010000000110000000000100000001
100000000001000000011000000000010000000110000000000100000001
100000000001000000011000000000010000000110000000000100000001
111111111111111111111111111111111111111111111111111111111111

000000000000000000000000000000000000000000000000000000000000
000000030000000000000000000000000000000000000000000000000000
000030000003000000000000000000000000000000000000000000000000
000000000000000000000000000000000000000000000000000000000000
000000000000000000000000000000000000000000000000000000000000
000002000100000000000000000000000000000000000000000000000000
000000000000000000000000000000000000000000000000000000000000
000000000000000000000000000000000000000000000000000000000000
000000000000000000000000000000000000000000000000000000000000
000000000000000000000000000000000000000000000000000000000000
000000000000000000000000000000000000000000000000000000000000
